##########
#    ~ ~9#
#1   ~  ~#
#_1  ~  5#
#1   ~  ~#
#    ~ ~9#
##########
